111111111111111111111111
10P000000100000000000011
1000000001000000000001E1
1000000000000000C0000111
100000000100000000000001
100000000100000000000001
1000000C0000000C00000001
100000000000000000000001
100000000000000000000001
100000000000000000000001
100000000000000000000001
111111111111111111111111