111111111111111111111111
11P10000011C000000000001
1010000001010000000000E1
1000000000000000C0000111
100000000100000000000001
100000010100000000000001
1000001C1000000C00000001
100000010000000000000001
100000000000000000000001
100000000000000000000001
100000000000000000000001
111111111111111111111111