111111111111111111111111
10P000000100000000000001
1000000001000000000000E1
1000000000000000C0000111
100000000100000000000001
100000000100000000000000
1000000C0000000C00000001
100000000000000000000000
100000000000000000000001
100000000000000000000000
100000000000000000000000
111111111111111111111111